5
12
Music/Dagoba_-_The_Things_Within.mp3
Pictures/Vorassic_bg.bmp
30 30 30 -31 -32 -31 -35 -31 30 30 30 30
30 -31 -31 -31 30 30 30 -31 -31 -31 -31 30
30 -30 -30 -30 30 30 30 -30 -30 -30 30 30
30 -31 -31 -31 30 30 30 -31 -31 -31 -31 30
30 30 30 -31 -34 -31 -33 -31 30 30 30 30
