7
10
Music/Eisenfunk_-_Conquer.mp3
Pictures/Vorassic_bg.bmp
-37 -37 -32 -31 -31 -31 -31 -33 -37 -37
-37 -37 1 1 1 1 1 1 -37 -37
-31 -31 -31 -31 1 1 -31 -31 -31 -31
-31 30 1 1 1 1 1 1 30 -31
-31 -31 -31 1 1 1 1 -31 -31 -31
-37 -37 1 1 1 1 1 1 -37 -37
-37 -37 -34 -31 -31 -31 -31 -35 -37 -37
