5
5
Music/Eisenfunk_-_Eiszeit.mp3
Pictures/x.jpg
1 1 1 1 1
1 -11 4 -10 1
1 3 28 3 1
1 -10 4 -11 1
1 1 1 1 1
